###########
#   #   ###
# #   #   #
# ## ######
###   # # #
# # ###   #
#   #   ###
## ## #   #
#   # # # #
# #     # #
###########
